1111111111111111111111111111111111111111
10C000000C00000000C0000000000110C01000C1
1P01111111111111111111111110000000C00111
110110C0001C111111C10C010000000000000001
110000000000C000000000000111111111111111
1101111C1111111111111111111C1C1C10011111
110000000000000000C000000000000000011111
1100111111111111111111111111111111001111
1100000000000C00000000000000C00000001111
1100000000000000000C00000000000000001111
11100000C0000000000000000000000000000111
11111000000000000G0000000000000000001111
1111101111111111111111111111111111111C11
100010111100C01111C11110C001111111C00011
101C100000000000000000000000011C01101111
1011111111111111111111111110111101101111
10000000000000000C0000000000000000000111
111111111111111111111111111111111111C111
111010C11C11000000000C000000000011110111
11E0000000000011001100000011000000000111
1111111111111111111111111111111111111111