1111111111111111111111111111111111111111
11000000C000000000000C0000000110C01000P1
1101111111111111111111111110000000000111
11011000C01C111111C10C10C1100000000000C1
1100000000000000000000000111111111011111
111111101111111111111111111C1C1C11C11111
1100000000000000000000000000000011111111
11001111111111111111111111111111110000E1
1100000C0000000000C00000000C000000001111
1100000000000000011100000000000000001111
1110000000000000000000000000000000001111
111110000000C000000G00000000000C00001111
1111111111111111111111111111111111111111
